* |* |*  |* |* |* |* |*  |* |*
^ |w^|fb^|w^|^ |^ |w^|fb^|w^|^
^ |w^|w^ |w^|^ |^ |w^|w^ |w^|^
^ |^ |^  |^ |^ |^ |^ |^  |^ |^
^ |^ |^  |^ |^ |^ |^ |^  |^ |^
^ |^ |^  |^ |^ |^ |^ |^  |^ |^
? |? |?  |? |? |? |? |?  |? |?
? |? |?  |? |? |? |? |?  |? |?
? |? |?  |? |? |? |? |?  |? |?
? |? |?  |? |? |? |? |?  |? |?
? |? |?  |? |? |? |? |?  |? |?
s |s |s  |s |s |s |s |s  |s |s