*|*|*|*|* |*|*|*|*|*
^|^|^|^|^ |^|^|^|^|^
^|^|^|^|^ |^|^|^|^|^
^|^|^|^|^ |^|^|^|^|^
^|^|^|^|^ |^|^|^|^|^
^|^|^|^|^ |^|^|^|^|^
?|?|?|?|? |?|?|?|?|?
?|?|?|?|? |?|?|?|?|?
?|?|?|?|? |?|?|?|?|?
?|?|?|?|? |?|?|?|?|?
?|?|?|?|m?|?|?|?|?|?
s|s|s|s|s |s|s|s|s|s